0000000000000000000000000000000000000000000000000000000000000000000000000000000000000
0000000000000000000000000000000000000000000000000000000000000000000000000000000000000
0000000000000000000000000000000000000000000000000000000000000000000000000000000000000
0000000000000000000000000000000000000000000000000000000000000000000000000000000000000
0000000000000000000000000000000000000000000000000000000000000000000000000000000000000
0000000000300000000004000000000000000000000000000050000000000000000000000000000000000
0000000000000000000000000000000000000000000000000000000000000000000000000000000000000
0000000000000000000000000000000000000000000000000000000000000000000000000000000000000
0000000000000000000000000000000000000000000000000000000000000000000000000000000000000
0000000000000000000000000000000000000000000000000000000000000000000000000000000000000
0000000000000000000000000000000000000000000000000000000000000000000000000000000000000
0000000000000000000000000000000000000000000000000000000000000000000000000000000000000
0000000000000000000000000000000000000000000000000000000000000000000000000000000000000
0000000000000000000000000000000000000000000000000000000000000000000000000000000000000
0000000000000000000000000000000000000000000000000000000000000000000000000000000000000
0000000000000000000000000000022222200000000000000000000000000000000000000000000000000
0000000000000000000000000000011111100000000000000000000000000000000000000000000000000
0000000000000000000000000002211111122000000000000000000000000000000000000000000000000
0000000000000000000000000001111111111000000000000000000000000000000000000000000000000
2222222222222222222222222221111111111222220002222222222222222222222222222222222222222
1111111111111111111111111111111111111111110001111111111111111111111111111111111111111
1111111111111111111111111111111111111111110001111111111111111111111111111111111111111