0000000000000000000000000000000000000000001000000000000000000000000000000000000000000000000000000000000000000
0000000000000000000000000000000000000000001000000000000000000000000000000000000000000000000000000000000000000
0000000000000000000000000000000000000000001000000000000000000000000000000000000000000000000000000000000000000
0000000000000000000022222222222220000002221000000000000000000000000000000000000000000000000000000000000000000
0000000000000000000011111111111110000000001222200000000000000000000000000000000000000000000000000000000000000
0000000000000000000011100000000010000000000000000022222222220000000000000000000000000000000000000000000000000
0000000000000000022211100000000010000000000000000000000000000000000000000000000000000000000000000000000000000
0000000000000000011111100000000010000000000000000000000000000000000000000000000000000000000000000000000000000
0000000000000000011111100000000010000000000000000000000000000000000000000000000000000000000000000000000000000
0000000000000000011111100002222210000000000000000000000000000000000000000000000000000000000000000000000000000
0000000000000022211111100000000000000000000000000000000000000000000000000000000000000000000000000000000000000
0000000000000011111111100000000000000000000000000000000000022222222200000000000000000000000000000000000000000
0000000000000011111111100000000000000000000000000000000000011111111100000000000000000000000000000000000000000
0000000000022211111111100000000000000000000000000000000222211111111100000000000000000000000000000000000000000
0000000000011111111111122222200000000000000000000000000111111111111100000000000000000000000000000000000000000
0000000000011111111111100000000000000000000000000000000111111111111100000000000000000000000000000000000000000
0000000002211111111111100000000000000000000000000002222111111111111100000000000000000000000000000000000000000
0000000001111111111111100000000000000000000000000001111111111111111100000000000000000000000000000000000000000
0000000001111111111111100000000000000000000000000001111111111111111100000000000000000000000000000000000000000
2222222221111111111111111111111111111111111111111111111111111111111111111111111111111100000000000000000000000
1111111111111111111111111111111111111111111111111111111111111111111111111111111111111100000000000000000000000
1111111111111111111111111111111111111111111111111111111111111111111111111111111111111100000000000000000000000