0000000000000000000000000000000000000000000000000000000000000000000000000000000000000000000000000000000000000000000000000
0000000000000000000000000000000000000000000000000000000000000000000000000000000000000000000000000000000000000000000000000
0000000000000000000000000000000000000000000000000022222220000000000000000000000000000000000000000000000000000000000000000
0000000000000000000000000000000000000000000022222222222222222222222220000000000000000000000000000000000000000000000000000
0000000002222220000000000000000000000000002222222222222222222222222222200000000000000000000000000000000000000000000000000
0000000000000000000000000000000000000000222222222222222222222222222222222000000000000000000000000000000000000000000000000
0000000000000000000000000000000000000022222222222222222222222222222222222220000000000000000000000000000000000000000000000
0000000000000000000000000000000000002222222222222222222222222222222222222222200000000000000000000000000000000000000000000
2222222222222222222222222222222222222222222222222222222222222222222222222222222222222222222222222222222222222222222222222
1111111111111111111111111111111111111111111111111111111111111111111111111111111111111111111111111111111111111111111111111
1111111111111111111111111111111111111111111111111111111111111111111111111111111111111111111111111111111111111111111111111