00000000002000000000030000000000000000000000000000400000000000000000000000
00000000000000000000000000000000000000000000000000000000000000000000000000
00000000000000000000000000000000000000000000000000000000000000000000000000
00000000000000000000000000000000000000000000000000000000000000000000000000
00000000000000000000000000000000000000000000000000000000000000000000000000
00000000000000000000000000000000000000000000000000000000000000000000000000
00000000000000000000000000000000000000000000000000000000000000000000000000
00000000000000000000000000000000011100000000000000000000000000000000000000
00000000000000000000000000000000011100000000000000000000000000000000000000
00000000000000000000000000000011111100000000000000000000000000000000000000
00000000000000000000000000000011111100000000000000000000000000000000000000
00000000000000000000000000000011111100000000000000000000000000000000000000
00000000000000000000000000011111111100000000000000000000000000000000000000
00000000000000000000000000011111111100000000000000000000000000000000000000
11111111111111111111111111111111111111111100011111111111111111111111111111
11111111111111111111111111111111111111111100011111111111111111111111111111
11111111111111111111111111111111111111111100011111111111111111111111111111