0000000000200000000003000000000000000000000000000040000000000000000000000000000000000000
0000000000000000000000000000000000000000000000000000000000000000000000000000000000000000
0000000000000000000000000000000000000000000000000000000000000000000000000000000000000000
0000000000000000000000000000000000000000000000000000000000000000000000000000000000000000
0000000000000000000000000000000000000000000000000000000000000000000000000000000000000000
0000000000000000000000000000000000000000000000000000000000000000000000000000000000000000
0000000000000000000000000000000000000000000000000000000000000000000000000000000000000000
0000000000000000000000000000000000000000000000000000000000000000000000000000000000000000
0000000000000000000000000000000000000000000000000000000000000000000000000000000000000000
0000000000000000000000000000000000000000000000000000000000000000000000000000000000000000
0000000000000000000000000000001111110000000000000000000000000000000000000000000000000000
0000000000000000000000000000001111110000000000000000000000000000000000000000000000000000
0000000000000000000000000000111111111100000000000000000000000000000000000000000000000000
0000000000000000000000000000111111111100000000000000000000000000000000000000000000000000
0000011111111111111111111111111111111111110001111111111111111111111111111111111111111111
0000011111111111111111111111111111111111110001111111111111111111111111111111111111111111
0000011111111111111111111111111111111111110001111111111111111111111111111111111111111111