0000000000000000000000000000000000000000001000000000000000000000000000001000000000000000000000000000000000000
00000000000000000000000000000000000000000010000000000000000000000000000010000000000000000000000000000000000000
00000000000000000000000000000000000000000010000000000000000000000000000010000000000000000000000000000000000000
00000000000000000000222222222222200000022210000000000000000000000000000010000000000000000000000000000000000000
00000000000000000000111111111111100000000012222000000000000000000000000010000000000000000000000000000000000000
00000000000000000000111000000000100000000000000000222222222200000000000010000000000000000000000000000000000000
00000000000000000222111000000000100000000000000000000000000000000000000010000000000000000000000000000000000000
00000000000000000111111000000000100000000000000000000000000000000000000010000000000000000000000000000000000000
00000000000000000111111000000000100000000000000000000000000000000000000010000000000000000000000000000000000000
00000000000000000111111000022222100000000000000000000000000000000000000010000000000000000000000000000000000000
00000000000000222111111000000000000000000000000000000000000000000000000010000000000000000000000000000000000000
00000000000000111111111000000000000000000000000000000000000222222222222212222222222222222222222222222222222222
00000000000000111111111000000000000000000000000000000000000111111111111111111111111111111111111111111111111111
00000000000222111111111000000000000000000000000000000002222111111111111111111111111111111111111111111111111111
00000000000111111111111222222000000000000000000000000001111111111111111111111111111111111111111111111111111111
00000000000111111111111000000000000000000000000000000001111111111111111111111111111111111111111111111111111111
00000000022111111111111000000000000000000000000000022221111111111111111111111111111111111111111111111111111111
00000000011111111111111000000000000000000000000000011111111111111111111111111111111111111111111111111111111111
00000000011111111111111000000000000000000000000000011111111111111111111111111111111111111111111111111111111111
22222222211111111111111111111111111111111111111111111111111111111111111111111111111111111111111111111111111111
11111111111111111111111111111111111111111111111111111111111111111111111111111111111111111111111111111111111111
11111111111111111111111111111111111111111111111111111111111111111111111111111111111111111111111111111111111111